X X X X X X X X X
X Z O Y O O O E X
X O O O O O O O X
X O X O O O X O X
X Z O O X Z O O X
X O X O O O X O X
X O X O O O O O X
X S O O O O Y O X
X X X X X X X X X